4	0	-23	24	24	23	0	1	4	4	4	1	4	1	4
4	0	0	24	21	24	0	4	0	0	0	4	1	4	1
4	0	0	24	24	0	0	4	0	0	0	4	4	4	4
4	0	0	0	0	0	0	4	0	0	0	0	0	2	1
4	0	0	0	0	0	0	4	0	0	0	0	0	0	4
1	4	1	4	1	4	1	1	1	4	0	0	0	0	4
4	0	0	0	4	1	4	4	4	1	0	0	0	0	1
4	0	0	0	4	4	4	4	4	4	0	0	0	0	4
1	0	0	0	0	0	4	4	0	0	0	0	0	0	4
4	0	0	0	0	0	0	4	0	0	0	21	24	21	0
1	1	4	0	0	0	0	4	0	0	0	24	21	24	-25
1	4	4	1	1	4	4	1	4	0	-23	24	24	24	24