5	0	-23	26	25	23	0	1	7	5	7	1	5	1	7
4	0	0	26	21	24	0	6	0	0	0	4	1	6	1
6	0	0	25	24	0	0	6	0	0	0	7	4	5	6
4	0	0	0	0	0	0	4	0	0	0	0	0	2	1
4	0	0	0	0	0	0	4	0	0	0	0	0	0	4
1	5	1	7	1	4	1	1	1	7	0	0	0	0	6
4	0	0	0	4	1	6	6	6	1	0	0	0	0	1
4	0	0	0	4	4	5	6	7	4	0	0	0	0	4
1	0	0	0	0	0	0	4	0	0	0	0	0	0	4
4	0	0	0	0	0	0	4	0	0	0	21	25	21	0
1	1	6	0	0	0	0	4	0	0	0	24	21	26	29
1	5	5	1	1	5	7	1	7	0	-23	27	24	25	24