0	1	1	1	1	1	1	1	1	1	0
0	1	0	0	0	0	0	0	0	1	0
0	1	0	0	0	-25	0	0	0	1	0
0	1	0	0	21	21	21	0	0	1	0
2	1	0	-23	21	0	21	23	0	1	2
0	1	0	0	22	21	22	0	0	1	0
0	1	0	0	0	25	0	0	0	1	0
0	1	0	0	0	0	0	0	0	1	0
0	2	1	1	1	1	1	1	1	2	0