2	1	1	1	1	0	-23	21	21	23	0	1	1	1	2
0	0	1	1	0	0	0	21	21	0	0	1	0	0	0
0	0	0	1	0	0	0	21	21	0	0	1	0	0	0
0	0	0	1	0	0	0	21	21	0	0	1	0	0	0
0	0	0	1	0	0	0	21	21	0	0	1	1	1	0
0	0	0	1	0	0	21	21	21	21	0	0	0	1	0
0	0	0	1	0	0	21	21	21	21	0	0	0	1	0
0	0	0	1	0	0	21	21	0	0	0	1	1	1	0
1	1	1	1	0	0	21	21	0	0	0	1	0	0	0
1	0	0	1	0	0	21	21	0	0	1	1	0	0	0
2	0	0	1	0	-23	21	21	23	0	1	1	1	1	2