0	2	1	0	-23	21	210	21	26	21	23	0	1	2	0
0	0	1	0	0	0	21	210	21	0	0	0	1	0	0
0	0	1	1	0	0	211	210	27	0	0	1	1	0	0
0	0	10	10	0	0	28	28	28	0	0	10	10	0	0
0	0	1	2	0	0	0	0	0	0	0	2	1	0	0
0	0	1	1	0	0	1	1	10	0	0	0	1	0	0
0	0	1	10	7	1	10	1	11	1	5	10	1	0	0
0	0	11	1	1	1	11	1	10	1	1	1	11	0	0
0	0	1	1	10	0	10	7	2	0	10	1	1	0	0
2	1	10	1	2	0	0	0	0	0	2	1	10	1	2