0	2	1	0	-23	21	27	21	26	21	23	0	1	2	0
0	0	1	0	0	0	21	27	21	0	0	0	1	0	0
0	0	1	1	0	0	28	27	24	0	0	1	1	0	0
0	0	7	7	0	0	25	25	25	0	0	7	7	0	0
0	0	1	2	0	0	0	0	0	0	0	2	1	0	0
0	0	1	1	0	0	1	1	7	0	0	0	1	0	0
0	0	1	7	4	1	7	1	8	1	4	7	1	0	0
0	0	8	1	1	1	8	1	7	1	1	1	8	0	0
0	0	1	1	7	0	7	4	2	0	7	1	1	0	0
2	1	7	1	2	0	0	0	0	0	2	1	7	1	2