0	2	1	0	-23	21	26	21	26	21	23	0	1	2	0
0	0	1	0	0	0	21	26	21	0	0	0	1	0	0
0	0	1	1	0	0	0	26	24	0	0	1	1	0	0
0	0	6	6	0	0	25	25	25	0	0	6	6	0	0
0	0	1	2	0	0	0	0	0	0	0	2	1	0	0
0	0	0	1	0	0	1	1	6	0	0	0	1	0	0
0	0	1	6	4	1	6	1	0	1	4	6	1	0	0
0	0	0	1	1	1	0	1	6	1	1	1	0	0	0
0	0	1	1	6	0	6	4	2	0	6	1	1	0	0
2	1	6	1	2	0	0	0	0	0	2	1	6	1	2